Map 1 - example
 7  5
-1 -1 -1 -1 -1 -1 -1
-1  1  1  1  1  1 -1
-1  1  1  1  1 -1  0
-1  1  1  1  1  1 -1
-1 -1 -1 -1 -1 -1 -1
